############################
#.............#............#
#......######.#......#######
#.............#......#######
#..#.#.#.#.#..#......#######
#...#...#....##......#######
#............##......#######
#............##......#######
#............##......#######
#............##......#######
#............##......#######
#............##......#######
#............##......#######
#............##......#######
#............##......#######
#............##......#######
#......########......#######
#............##......#######
#..#.#.#.#.#.##......#######
#...#...#....##......#######
#............##......#######
#............##......#######
#............##......#######
#............##......#######
#............##......#######
#............##......#######
#............##......#######
############################