##############################
#..@..@@@@@@@@@@@@@@@@@@@@@..#
#..#..#..@@@@@@@@@@@@@@@@....#
#..#..#...###############....#
#............................#
#............................#
#.......@@@@#######..........#
#.........*@@.....#..........#
#.........*@@@...............#
#......****@@@....#.#........#
#.**********@.....#@.*.......#
#***********......###........#
#.................*..........#
#.................***........#
#.................*.....@....#
#..............#..*....#@#...#
#..............#..#....@@@...#
#..............#..#.....@....#
#......############..........#
#............................#
#..#.#.#.#.#.#.#.#...........#
#...#.*.#.*.#.*.#............#
#............................#
#.............@........##....#
#............@@@........#....#
#...........@@@@@......##....#
#............@@@.......#.....#
#.............@........#.....#
#............................#
##############################