##############################
#..@..@@@@@@@@@@@@@@@@@@@@@..#
#..#..#..@@@@@@@@@@@@@@@@....#
#..#..#...###############....#
#............................#
#............................#
#.......@@@@#######..........#
#.........@@@@@@@@#..........#
#.........*@@@@@@@...........#
#......****@@@@@@.#.....###..#
#.**********@@....#@....#....#
#***********......###..****..#
#.................*..........#
#.................*..........#
#.................***...@....#
#........#...###..*...#@@#...#
#........#.....#..#....@@@...#
#........#.....#..#.....@....#
#......############..........#
#............................#
#............................#
#..##**##**##**##.....####...#
#..##**##**##**##.......##...#
#.............@.........##...#
#............@@@........##...#
#...........@@@@@.....####...#
#............@@@......##.....#
#.............@.......##.....#
#............................#
##############################